#####################
#A                  #
# ##### ########### #
# #   #   #         #
# # ### # # #########
#     # # #         #
##### ### ### ###### #
#     #       #      #
# ### ######### #### #
# #   #       #      #
# # ##### ##### ######
#   #     #   #      #
# ### ### ### # #### #
#   # #     # #      #
### # ##### ##### ####
#   #     #       #  #
# ######### ### #### #
#         #   #      #
######### ##### #######
#         #           #
# ######### ###########
#B                  #
#####################